github.com/error-log-or-return/error-log-or-return/internal/analizer/analizer.go:31:	filterFiles		71.4%
github.com/error-log-or-return/error-log-or-return/internal/analizer/analizer.go:68:	hasNoLintComment	100.0%
github.com/error-log-or-return/error-log-or-return/internal/analizer/analizer.go:101:	getReceiverName		100.0%
github.com/error-log-or-return/error-log-or-return/internal/analizer/analizer.go:109:	returnsError		83.3%
github.com/error-log-or-return/error-log-or-return/internal/analizer/analizer.go:122:	hasErrorVariable	100.0%
github.com/error-log-or-return/error-log-or-return/internal/analizer/analizer.go:132:	hasErrorInDeclStmt	61.9%
github.com/error-log-or-return/error-log-or-return/internal/analizer/analizer.go:170:	hasErrorInAssignStmt	27.3%
github.com/error-log-or-return/error-log-or-return/internal/analizer/analizer.go:192:	hasDeferWithErrorRef	79.2%
github.com/error-log-or-return/error-log-or-return/internal/analizer/analizer.go:238:	checkFunctionViolations	88.2%
github.com/error-log-or-return/error-log-or-return/internal/analizer/analizer.go:272:	run			88.9%
github.com/error-log-or-return/error-log-or-return/internal/analizer/analizer.go:289:	Run			0.0%
github.com/error-log-or-return/error-log-or-return/internal/analizer/init.go:18:	init			58.3%
github.com/error-log-or-return/error-log-or-return/internal/analizer/init.go:36:	extractBasePath		100.0%
github.com/error-log-or-return/error-log-or-return/internal/config/config.go:18:	defaultConfig		100.0%
github.com/error-log-or-return/error-log-or-return/internal/config/config.go:31:	findConfigFile		100.0%
github.com/error-log-or-return/error-log-or-return/internal/config/config.go:51:	matchPattern		100.0%
github.com/error-log-or-return/error-log-or-return/internal/config/config.go:61:	ShouldIgnore		100.0%
github.com/error-log-or-return/error-log-or-return/internal/config/config.go:75:	LoadConfig		87.5%
github.com/error-log-or-return/error-log-or-return/main.go:11:				main			0.0%
total:											(statements)		75.4%
